222222222222222222222222222222222222222222222222222222222222222222222222222222222222222222222222-
222222222222222222222222222222222222222222222222222222222222222222222222222222222222222222222222-
222222222222222222222222222222222222222222222222222222222222222222222222222222222222222222222222-
222222222222222222222222222222222222222222222222222222222222222222222222222222222222222222222222-
222222222222222222222222222222222222222222222222222222222222222222222222222222222222222222222222-
222222222222222222222222222222222222222222222222222222222222222222222222222222222222222222222222-
222222222222222222222222222222222222222222222222222222222222222222222222222222222222222222222222-
222222222222222222222222222222222222222222222222222222222222222222222222222222222222222222222222-
222222222222222222222222222222222222222222222222222222222222222222222222222222222222222222222222-
222222222222222222222222222222222222222222222222222222222222222222222222222222222222222222222222-
222222222222222222222222222222222222222222222222222222222222222222222222222222222222222222222222-
222222222222222222222222222222222222222222222222222222222222222222222222222222222222222222222222-
222222222222222222222222222222222222222222222222222222222222222222222222222222222222222222222222-
222222222222222222222222222222222222222222222222222222222222222222222222222222222222222222222222-
222222222222222222222222222222222222222222222222222222222222222222222222222222222222222222222222-
222222222222222222221111111222222222212222222222222222222222222222222222222222222222222222222222-
222222222222222222222222222222222222222222222222222222222222222222222222222222222222222222222222-
222222222222222222222222222222222222222222222222222222222222222222222222222222222222222222222222-
222222222222222222222222222222222222222222222222222222222222222222222222222222222222222222222222-
000000000000000000000000000000000000000000000000000000000000000000000000000000000000000000000000-
000000000000000000000000000000000000000000000000000000000000000000000000000000000000000000000000