222222222222222222222222222222222222222222222222222222222222222222222222222222222222222222222222-
222222222222222222222222222222222222222222222222222222222222222222222222222222222222222222222222-
222222222222222222222222222222222222222222222222222222222222222222222222222222222222222222222222-
222222222222222222222222222222222222222222222222222222222222222222222222222222222222222222222222-
222222222222222222222222222222222222222222222222222222222222222222222222222222222222222222222222-
222222222222222222222222222222222222222222222222222222222222222222222222222222222222222222222222-
222222222222222222222222222222222222222222222222222222222222222222222222222222222222222222222222-
222222222222222222222222222222222222222222222222222222222222222222222222222222222222222222222222-
222222222222222222222222222222222222222222222222222222222222222222222222222222222222222222222222-
222222222222222222222222222222222222222222222222222222222222222222222222222222222222222222222222-
222222222222222222222222222222222222222222222222222222222222222222222222222222222222222222222222-
222222222222222222222222222222222222222222222222222222222222222222222222222222222222222222222222-
222222222222221112222222222222222222222222222222222222222222222222222222222222222222222222222222-
222222222222222222222222222222222222222222222222222222222222222222222222222222222222222222222222-
222222222222222222222222222222222222222222222222222222222222222222222222222222222222222222222222-
222222222222222222221111111222222222222222222222222222222222222222222222222222222222222222222222-
222222222122222222222222222222222222222222222222222222222222222222222222222222222222222222222222-
222222221112222222222222222222222222222222222222222222222222222222222222222222222222222222222222-
222222211111222222222222222222222222222222222222222222222222222222222222222222222222222222222222-
000000000000000000000000000000000000000000000000000000000000000000000000000000000000000000000000-
000000000000000000000000000000000000000000000000000000000000000000000000000000000000000000000000