222222222222222222222222222222222222222222222222222222222222222222222222222222222222222222222222-
222222222222222222222222222222222222222222222222222222222222222222222222222222222222222222222222-
222222222222222222222222222222222222222222222222222222222222222222222222222222222222222222222222-
222222222222222222222222222222222222222222222222222222222222222222222222222222222222222222222222-
222222222222222222222222222222222222222222222222222222222222222222222222222222222222222222222222-
222222222222222222222222222222222222222222222222222222222222222222222222222222222222222222222222-
222222222222222222222222222222222222222222222222222222222222222222222222222222222222222222222222-
222222222222222222222222222222222222222222222222222222222222222222222222222222222222222222222222-
222222222222222222222222222222222222222222222222222222222222222222222222222222222222222222222222-
222222222222222222222222222222222222222222222222222222222222222222222222222222222222222222222222-
222222222222222222222222222222222222222222222222222222222222222222222222222222222222222222222222-
222222222222222222222222222222222222222222222222222222222222222222222222222222222222222222222222-
222222222222222222222222222222222222222222222222222222222222222222222222222222222222222222222222-
222222222222222222222222222222222222222222222222222222222222222222222222222222222222222222222222-
222222222222222222222222222222222222222222222222222222222222222222222222222222222222222222222222-
222222222222222222222222111222222222222222222222222222222222222222222222222222222222222222222222-
222222222222222222222222222222222222222222222222222222222222222222222222222222222222222222222222-
222222222222221122222222222222222222222222222222222222222222222222222222222222222222222222222222-
222222222222211112222222222222222222222222222222222222222222222222222222222222222222222222222222-
000000000000000000000000000000000000000000000000000000000000000000000000000000000000000000000000-
000000000000000000000000000000000000000000000000000000000000000000000000000000000000000000000000