222222222222222222222222222222222222222222222222222222222222222222222222222222222222222222222222-
222222222222222222222222222222222222222222222222222222222222222222222222222222222222222222222222-
222222222222222222222222222222222222222222222222222222222222222222222222222222222222222222222222-
222222222222222222222222222222222222222222222222222222222222222222222222222222222222222222222222-
222222222222222222222222222222222222222222222222222222222222222222222222222222222222222222222222-
222222222222222222222222222222222222222222222222222222222222222222222222222222222222222222222222-
222222222222222222222222222222222222222222222222222222222222222222222222222222222222222222222222-
222222222222222222222222222222222222222222222222222222222222222222222222222222222222222222222222-
222222222222222222222222222222222222222222222222222222222222222222222222222222222222222222222222-
222222222222222222222222222222222222222222222222222222222222222222222222222222222222222222222222-
222222222222222222222222222222222222222222222222222222222222222222222222222222222222222222222222-
222222222222222222222222222222222222222222222222222222222222222222222222222222222222222222222222-
222222222222222222222222222222222222222222222222222222222222222222222222222222222222222222222222-
222222222222222222222222222222222222222222222222222222222222222222222222222222222222222222222222-
222222222222222222222222222222222222222222222222222222222222222222222222222222222222222222222222-
222222222222222222221222222222222222222222222222222222222222222222222222222222222222222222222222-
222222222222221222221222222222222222222222222222222222222222222222222222222222222222222222222222-
222222222222211122221222222222222222222222222222222222222222222222222222222222222222222222222222-
222222222222111112221222222222222222222222222222222222222222222222222222222222222222222222222222-
000000000000000000000000000000000000000000000000000000000000000000000000000000000000000000000000-
000000000000000000000000000000000000000000000000000000000000000000000000000000000000000000000000